{
    "name": "Serene Pond",
    "width": 9,
    "height": 8,
    "grid": [
        [0, 0, 0, 0, 0, 0, 0, 0, 0],
        [0, 0, 1, 1, 1, 0, 0, 0, 0],
        [0, 1, 1, 1, 1, 1, 1, 1, 0],
        [0, 1, 1, 1, 1, 1, 1, 1, 0],
        [0, 0, 1, 1, 1, 1, 1, 0, 0],
        [0, 0, 1, 1, 1, 1, 1, 0, 0],
        [0, 0, 0, 0, 1, 1, 1, 0, 0],
        [0, 0, 0, 0, 0, 1, 1, 0, 0]
    ]
}
